7,7,7,7,7,7,7,7,7,7,7,7,7,7,7,7;
7,7,7,7,12,12,12,7,7,12,12,7,7,7,7,7;
7,7,7,12,12,12,12,12,12,12,12,12,12,7,7,7;
7,7,12,12,12,12,12,12,12,12,12,12,12,7,7,7;
7,7,12,12,12,12,12,12,12,12,12,12,12,7,7,7;
7,7,7,12,12,12,12,12,12,12,12,12,7,7,7,7;
7,7,12,12,12,12,12,12,12,12,12,12,7,7,7,7;
7,7,7,12,12,12,12,12,12,12,12,7,7,7,7,7;
7,7,7,12,12,12,12,12,12,12,7,7,7,7,7,7;
7,7,7,7,7,12,12,12,12,7,7,7,7,7,7,7;
7,7,7,7,7,7,7,7,7,7,7,7,7,7,7,7;
7,7,7,7,7,7,7,7,7,7,7,7,7,7,7,7;